11121121112111112121
22121211211122212111
12121112121211111221
12112212111222221121
11212111221111112111
21211221121222211212
11121112211111212211
12112211121221212121
12211122121122112121
11122221122112121111
12111111212121112222
12212222112121221111
11122111121121111221
22111212111211222111
11221121122112111212
12112112321122121211
11121211211211121121
21211112112121211211
11212221221111212112
21111111111212111112